------X--------X------
------X--X--X--X------
------X--X--X--X------
---XXXX--X--X--XXXX---
---X-----X--X-----X---
---X-----X--X-----X---
--XX-----X--X-----XX--
--X----XXX--XXX----X--
--X----X------X----X--
--X----X------X----X--
-------X------X-------
-------X------X-------
-------X------X-------