----------XX----------
-----XXX--XX--XXX-----
-------X--XX--X-------
--XXXXXX--XX--XXXXXX--
--X-------XX-------X--
--X-------XX-------X--
--XXXX---XXXX---XXXX--
-----X--XX--XX--X-----
-----X--X----X--X-----
---XXX--X----X--XXX---
---X----XX--XX----X---
---X--------------X---
---X--------------X---
---X--------------X---